06,06,06,06,06,06,06,06,06,06,06,06,06,06,06,06,06,06,06,06,06,06,06,06,21
00,00,00,00,00,00,00,00,00,00,00,00,00,00,00,00,00,00,00,00,00,00,11,06,21
01,01,01,01,01,03,02,01,01,01,01,01,01,01,01,01,01,01,01,01,01,12,13,06,21
06,06,06,06,06,04,05,06,06,06,06,06,06,21,21,21,21,21,21,21,06,14,13,06,21
06,21,21,21,06,06,06,06,06,21,21,21,21,21,06,06,06,06,06,21,06,14,13,06,21
06,21,06,21,21,21,21,21,21,21,06,06,06,06,06,10,09,06,06,06,06,14,13,21,21
21,21,17,00,00,00,00,00,00,00,00,00,00,00,00,07,08,00,00,00,00,16,13,21,06
21,06,14,18,01,01,01,01,01,01,01,01,01,01,01,01,01,01,01,01,01,01,15,21,06
06,06,14,13,06,06,06,21,21,06,21,21,21,21,21,21,21,21,21,21,21,06,06,06,06
21,21,14,13,06,06,06,06,21,21,21,06,06,06,06,06,06,06,06,06,21,21,06,06,06
06,21,14,20,00,00,00,00,00,00,00,00,00,00,00,00,00,00,00,00,00,00,11,06,21
06,21,19,01,01,01,01,01,03,02,01,01,01,01,01,01,01,01,01,01,01,12,13,06,21
06,21,06,06,06,06,06,06,04,05,06,06,06,06,06,06,06,06,21,21,06,14,13,06,21
06,21,06,06,06,06,06,06,06,06,06,06,06,06,06,06,06,21,21,06,06,14,13,06,21
06,21,06,06,06,21,21,21,21,21,21,21,06,06,06,21,21,21,06,06,06,14,13,21,21
06,21,21,06,06,06,06,06,06,06,06,21,21,21,21,21,06,06,21,06,06,14,13,21,06
06,06,21,06,06,06,06,06,06,06,06,06,06,06,06,06,06,06,21,06,06,14,13,06,06
06,06,21,21,06,06,21,21,21,21,21,21,21,21,21,06,06,21,21,06,06,14,13,06,06
06,06,06,06,21,21,21,06,06,06,06,06,06,06,21,21,21,21,06,06,06,14,20,00,00
06,06,06,06,06,06,06,06,06,06,06,06,06,06,06,06,06,06,06,06,06,19,01,01,01

0,0,0,0,0,0,0,0,0,0,0,0,0,0,0,0,0,0,0,0,0,0,0,0,1
0,0,0,0,0,0,0,0,0,0,0,0,0,0,0,0,0,0,0,0,0,0,0,0,1
0,0,0,0,0,0,0,0,0,0,0,0,0,0,0,0,0,0,0,0,0,0,0,0,1
0,0,0,0,0,0,0,0,0,0,0,0,0,0,0,0,0,0,0,0,0,0,0,0,1
1,1,1,1,1,1,1,1,1,1,1,1,1,1,1,1,1,1,1,1,0,0,0,0,1
1,0,0,0,0,0,0,0,0,0,0,0,0,0,0,0,0,0,0,0,0,0,0,0,1
1,0,0,0,0,0,0,0,0,0,0,0,0,0,0,0,0,0,0,0,0,0,0,0,1
1,0,0,0,0,0,0,0,0,0,0,0,0,0,0,0,0,0,0,0,0,0,0,0,1
1,0,0,0,0,1,1,1,1,1,1,1,1,1,1,1,1,1,1,1,1,1,1,1,1
1,0,0,0,0,0,0,0,0,0,0,0,0,0,0,0,0,0,0,0,0,0,0,0,1
1,0,0,0,0,0,0,0,0,0,0,0,0,0,0,0,0,0,0,0,0,0,0,0,1
1,0,0,0,0,0,0,0,0,0,0,0,0,0,0,0,0,0,0,0,0,0,0,0,1
1,0,0,0,0,0,0,0,0,0,0,0,0,0,0,0,0,0,0,0,0,0,0,0,1
1,0,0,0,0,0,0,0,0,0,0,0,1,1,1,1,1,1,1,1,0,0,0,0,1
1,1,1,1,1,1,1,1,1,1,1,1,1,0,0,0,0,0,0,1,0,0,0,0,1
0,0,0,0,0,0,0,0,0,0,0,0,0,0,0,0,0,0,0,1,0,0,0,0,1
0,0,0,0,0,0,0,0,0,0,0,0,0,0,0,0,0,0,0,1,0,0,0,0,0
0,0,0,0,0,0,0,0,0,0,0,0,0,0,0,0,0,0,0,1,0,0,0,0,0
0,0,0,0,0,0,0,0,0,0,0,0,0,0,0,0,0,0,0,1,0,0,0,0,0
0,0,0,0,0,0,0,0,0,0,0,0,0,0,0,0,0,0,0,1,0,0,0,0,0

