06,06,06,06,06,06,06,06,06,06,06,06,06,06,06,06,06,06,06,06,06,06,06,06,06
00,00,00,00,00,00,00,00,00,00,00,00,00,00,00,00,00,00,00,00,00,00,00,11,06
02,03,01,01,01,01,01,01,01,01,01,01,01,01,01,01,01,01,01,01,01,01,12,13,06
04,05,06,06,21,21,06,06,06,06,06,06,06,06,06,06,06,06,21,06,06,06,14,13,06
06,21,21,21,21,21,21,21,21,21,21,21,21,21,21,21,21,21,21,21,21,21,14,13,06
21,21,06,06,06,21,21,06,06,06,06,06,06,06,21,06,06,06,06,06,06,06,14,13,06
06,17,00,00,00,00,00,00,00,00,00,00,00,00,00,00,00,00,00,00,00,00,16,13,06
06,14,18,01,01,01,01,01,01,01,01,01,01,01,01,01,01,01,01,01,01,01,01,15,06
06,14,13,06,06,21,21,21,21,21,21,06,06,06,06,06,21,21,21,21,21,06,06,06,06
06,14,13,06,06,06,06,06,06,06,21,21,21,21,21,21,21,06,06,06,21,21,21,21,06
06,14,13,06,06,06,06,06,06,06,06,06,21,21,06,06,06,06,06,06,06,06,06,06,06
06,14,20,00,00,00,00,00,00,00,00,00,00,00,00,00,00,00,00,00,00,00,00,11,06
06,19,01,01,01,01,01,01,01,01,01,01,01,01,01,01,01,01,01,01,01,01,12,13,06
06,06,06,06,06,06,06,21,21,21,06,21,21,21,21,21,06,06,06,06,06,06,14,13,06
06,06,06,06,21,21,21,21,06,21,21,21,06,06,06,21,21,21,21,21,21,06,14,13,06
06,06,06,06,06,06,06,06,06,06,06,06,06,06,06,06,06,06,21,21,06,06,14,13,06
06,17,00,00,00,00,00,00,00,00,00,00,00,00,00,00,00,00,00,00,00,00,16,13,06
06,19,01,01,01,01,01,01,01,01,01,01,01,01,01,01,01,01,01,01,01,01,01,15,06
06,06,21,21,21,21,21,21,21,06,06,06,06,06,06,06,06,06,06,06,06,06,06,06,21
06,06,06,06,06,06,06,06,21,21,21,21,21,21,21,21,21,21,21,21,21,21,21,21,21

0,0,0,0,0,0,0,0,0,0,0,0,0,0,0,0,0,0,0,0,0,0,0,0,1
0,0,0,0,0,0,0,0,0,0,0,0,0,0,0,0,0,0,0,0,0,0,0,0,1
0,0,0,0,0,0,0,0,0,0,0,0,0,0,0,0,0,0,0,0,0,0,0,0,1
0,0,0,0,0,0,0,0,0,0,0,0,0,0,0,0,0,0,0,0,0,0,0,0,1
1,1,1,1,1,1,1,1,1,1,1,1,1,1,1,1,1,1,1,1,1,0,0,0,1
1,0,0,0,0,0,0,0,0,0,0,0,0,0,0,0,0,0,0,0,0,0,0,0,1
1,0,0,0,0,0,0,0,0,0,0,0,0,0,0,0,0,0,0,0,0,0,0,0,1
1,0,0,0,0,0,0,0,0,0,0,0,0,0,0,0,0,0,0,0,0,0,0,0,1
1,0,0,0,0,0,0,0,0,0,0,0,0,0,0,0,0,0,0,0,0,0,0,0,1
1,0,0,0,1,1,1,1,1,1,1,1,1,1,1,1,1,1,1,1,1,1,1,1,1
1,0,0,0,0,0,0,0,0,0,0,0,0,0,0,0,0,0,0,0,0,0,0,0,1
1,0,0,0,0,0,0,0,0,0,0,0,0,0,0,0,0,0,0,0,0,0,0,0,1
1,0,0,0,0,0,0,0,0,0,0,0,0,0,0,0,0,0,0,0,0,0,0,0,1
1,0,0,0,0,0,0,0,0,0,0,0,0,0,0,0,0,0,0,0,0,0,0,0,1
1,1,1,1,1,1,1,1,1,1,1,1,1,1,1,1,1,1,1,1,1,0,0,0,1
0,0,0,0,0,0,0,0,0,0,0,0,0,0,0,0,0,0,0,0,0,0,0,0,1
0,0,0,0,0,0,0,0,0,0,0,0,0,0,0,0,0,0,0,0,0,0,0,0,1
0,0,0,0,0,0,0,0,0,0,0,0,0,0,0,0,0,0,0,0,0,0,0,0,1
1,1,1,1,1,1,1,1,1,1,1,1,1,1,1,1,1,1,1,1,1,1,1,1,1
0,0,0,0,0,0,0,0,0,0,0,0,0,0,0,0,0,0,0,0,0,0,0,0,1

